NO ./House.png
SO ./Rainbow.png
WE ./Parrot.png
EA ./NormalTree.png
F 0,0,0
C 51,198,227

1111111111111
1010000000011
100E000000001
1000001000001
1111111111111