NO ./test.png
SO ./SO.png
WE ./WE.png
EA ./EA.png
F 220,100,0
C 225,30,0
111111111
1011111S111
111111111