NO ./test.png
SO ./SO.png
WE ./WE.png
EA ./EA.png
F 220,100,0
C 225,30,0
111111111
100000001
100000001
100000S01
100000001
100000001
101000001
100000001
111111111