NO  ./path_to_the_north_texture.png
SO ./path_to_the_south_texture.png
WE ./path_to_the_west_texture.png
EA ./path_to_the_east_texture.png
F 220,100,10
C    244,30,10


111111
1101111
1111S1
  11111   1       1
