NO ./test.png
SO ./SO.png
WE ./WE.png
EA ./EA.png
F 220,100,255
C 1,30,0
111111111
100000001
100000001
100000001
100000001
1000N0001
101000001
100000001
100000001
100000001
100000001
100000001
111111111