NO ./path_to_the_north_texture.png
SO ./path_to_the_south_texture.png
WE ./path_to_the_west_texture.png
EA ./path_to_the_east_texture.png
F 220,100,0
C 225,30,0


1111111
100001
10N1111
101111
111101
1011011
111111
1111111
10000110
101111
101111
111101
1011011
    1111110
  1  